0 1 2 3 4 5 6 7 8 9 10 11 12 13 14 -1 -1 -1 -1 -1 -1
-1 -1 -1 -1 -1 -1 -1 -1 -1 -1 -1 -1 -1 -1 15 -1 -1 -1 -1 -1
-1 -1 -1 -1 -1 -1 -1 -1 -1 -1 -1 19 18 17 16 -1 -1 -1 -1 -1
-1 -1 -1 -1 -1 -1 -1 -1 -1 -1 -1 20 -1 -1 -1 -1 -1 -1 -1 -1
-1 -1 -1 -1 -1 -1 -1 -1 -1 -1 -1 21 22 23 24 25 26 27 28 29 
-1 -1 -1 52 51 50 -1 -1 -1 -1 -1 -1 -1 -1 -1 -1 -1 -1 -1 30 
-1 -1 -1 53 -1 49 -1 -1 -1 -1 -1 -1 -1 -1 -1 -1 -1 -1 -1 31
-1 -1 -1 54 -1 48 -1 -1 -1 -1 -1 -1 -1 -1 -1 -1 -1 -1 -1 32
-1 -1 -1 55 -1 47 46 45 44 43 42 41 40 39 38 37 36 35 34 33
-1 -1 -1 56 -1 -1 -1 -1 -1 -1 -1 -1 -1 -1 -1 -1 -1 -1 -1 -1
-1 -1 -1 57 -1 -1 -1 -1 -1 -1 -1 73 74 75 76 -1 -1 -1 -1 -1
-1 -1 -1 58 -1 -1 -1 -1 -1 -1 -1 72 -1 -1 77 -1 -1 -1 -1 -1
-1 -1 -1 59 -1 -1 -1 -1 -1 -1 -1 71 -1 79 78 -1 -1 -1 -1 -1
-1 -1 -1 60 -1 -1 -1 -1 -1 -1 -1 70 -1 80 -1 -1 -1 -1 -1 -1
-1 -1 -1 61 62 63 64 65 66 67 68 69 -1 81 82 83 84 85 86 87
-1 -1 -1 -1 -1 -1 -1 -1 -1 -1 -1 -1 -1 -1 -1 -1 -1 -1 -1 90
-1 -1 -1 -1 -1 -1 -1 -1 -1 -1 -1 -1 -1 -1 -1 -1 -1 -1 -1 91
-1 -1 -1 -1 -1 -1 -1 -1 -1 -1 -1 -1 -1 -1 -1 -1 -1 -1 -1 92
-1 -1 -1 -1 -1 -1 -1 -1 -1 -1 -1 -1 -1 99 98 97 96 95 94 93
-1 -1 -1 -1 -1 -1 -1 -1 -1 -1 -1 -1 -1 100 -1 -1 -1 -1 -1 -1